1111111111
1000000001

1P0C0E0001
1111111111
