1111111111
1000000001
1E000000C1
1000000001
1111000011
1P10000001
1111111111
