111111111
a11111111
100000001
100000001
111111111
