111111111
1E0000001
100000001
100000001
100000C01
111111111
