1111111111
0111111111
1000000001
1000000001
1111111111
