111111111
1P0000001
100110001
100000001
111111111
