111111111111111
1E00000C0000001
1111100C000C111
111111011111111
1C000000000C001
111111001111001
1P00000000000C1
111111111111111
