1111111111111111
100C00000000E001
1000000111110001
100000000C000001
1001111110000001
1C00000000001101
111111100000P001
1111111111111111
