111111111111
100000000001
1000000000001
100000000001
111111111111
